आप	PRP	S
वाहन	NN	I
के	PSP	I
रिजस्ट्रेशन	NN	I
के	PSP	I
दस्तावेजऋ	NN	I
माऋग	VM	I
सकते	VAUX	I
हैं	VAUX	E
और	CC	O
उसके	PRP	S
अंतिम	JJ	I
मालिक	NN	I
से	PSP	I
संपर्क	NN	I
करके	VM	I
माऋलेज	NN	I
जाऋच	VM	I
सकते	VAUX	I
हैं	VAUX	E
।	SYM	O