विगत	JJ	S
कुछ	QF	I
वर्गो	NN	I
में	PSP	I
इस	DEM	I
दिशा	NN	I
में	PSP	I
लिया	VM	I
गया	VAUX	I
स्वागत	NN	I
योग़्य	NNC	I
कदम	NN	I
यह	PRP	I
है	VM	E
कि	CC	O
नेशनल	NNPC	S
बुक	NNPC	I
ट्रस्ट	NNP	I
लेखकों	NN	I
के	PSP	I
अल्पकालीन	JJ	I
शिविर	NN	I
आयोजित	JJ	I
करते	VM	I
रहा	VAUX	I
है	VAUX	I
,	SYM	I
जिसमे	PRP	I
विभिन्न	JJ	I
क्षेत्रीय	JJ	I
भाषाओं	NN	I
के	PSP	I
लेखक	NN	I
भाग	NN	I
लेते	VM	I
रहे	VAUX	E
और	CC	O
अपने	PRP	S
आदान-प्रदान	NNC	I
कार्यक्रम	NN	I
के	PSP	I
अंतर्गत	PSP	I
,	SYM	I
प्रत्येक	QF	I
भाषा	NN	I
की	PSP	I
कुछ	QF	I
चुनी	VM	I
हुई	VAUX	I
पुस्तकों	NN	I
का	PSP	I
अन्य	JJ	I
सभी	QF	I
भाषाओं	NN	I
मे	PSP	I
प्रकाशन	NN	I
करते	VM	I
रहे	VAUX	I
हैं	VAUX	E
।	SYM	O