इन्हें	PRP	S
अपर	NNC	I
सत्र	NNC	I
न्यायाधीश	NN	I
अथवा	CC	I
सहायक	NNC	I
सत्र	NNC	I
न्यायाधीश	NN	I
कहा	VM	I
जाता	VAUX	I
है	VAUX	I
;	CC	I
ये	DEM	I
सब	RB	I
उसी	DEM	I
न्यायालय	NN	I
के	PSP	I
न्यायाधीश	NN	I
होते	VM	I
हैं	VAUX	E
।	SYM	O