आप	PRP	S
यह	PRP	I
देखेंगे	VM	E
कि	CC	O
शुरू	NN	S
के	PSP	I
दिनों	NN	I
में	PSP	I
कोई	PRP	I
पचास-एक	QC	I
बरस	NN	I
पहले	NST	I
Zकुछ	SYM	I
बडे	JJ	I
बडे	JJ	I
रईस	JJ	I
लोग	NN	I
आपस	PRP	I
में	PSP	I
बैठकें	NN	I
किया	VM	I
करते	VAUX	I
थे	VAUX	I
और	CC	I
वफादार	JJ	I
रहने	VM	I
की	PSP	I
अजीबो-गरीब	JJ	I
बातें	NN	I
किया	VM	I
करते	VAUX	I
थे	VAUX	E
।	SYM	O