कभी	PRP	S
कभी	PRP	I
केवल	RP	I
भारत	NNP	I
कहा	VM	I
जाने	VAUX	I
वाला	PSP	I
यह	DEM	I
काव्यग्रंथ	NN	I
भारत	NNP	I
का	PSP	I
अनुपम	JJ	I
धार्मिक	JJ	I
पौराणिक	JJ	I
ऐतिहासिक	JJ	I
और	CC	I
दार्शनिक	JJ	I
ग्रंथ	NN	I
हैं	VM	E
।	SYM	O