गुम्बद	NN	S
एवं	CC	I
छतरियों	NN	I
के	PSP	I
शिखर	NN	I
पर	PSP	I
परंपरागत	JJ	I
फारसी	NNP	I
एवं	CC	I
हिंदू	NNPC	I
वास्तु	NNC	I
कला	NN	I
का	PSP	I
प्रसिद्ध	JJ	I
घटक	NN	I
एक	QC	I
धात्विक	JJ	I
कलश	NN	I
किरीटरूप	NN	I
में	PSP	I
शोभायमान	JJ	I
है	VM	E
।	SYM	O