इस	DEM	S
समस्या	NN	I
का	PSP	I
मूल	JJ	I
कारण	NN	I
अत्यन्त	INTF	I
मानवीय	JJ	I
है	VM	I
अपनी	PRP	I
आधिकारिक	JJ	I
स्थिति	NN	I
में	PSP	I
अपने	PRP	I
अधिकार	NN	I
का	PSP	I
प्रयोग	NN	I
करते	VM	I
हुये	VAUX	I
व्यक्तिगत	JJ	I
लाभ	NN	I
के	PSP	I
लिये	PSP	I
वे	PRP	I
कानून	NN	I
और	CC	I
प्रक्रिया	NN	I
तोडते	VM	I
हैं	VAUX	E
।	SYM	O