मगर	CC	O
उनके	PRP	S
निधन	NN	I
के	PSP	I
पश्चात	NST	I
उनके	PRP	I
भाई	NN	I
सरदार	NNPC	I
वल्लभ	NNPC	I
भाई	NNPC	I
पटेल	NNP	I
ने	PSP	I
इस	DEM	I
वसीयत	NN	I
को	PSP	I
स्वीकार	NN	I
नहीं	NEG	I
किया	VM	E
और	CC	O
उसपर	PRP	S
अदालत	NN	I
में	PSP	I
मुकदमा	NN	I
चलाया	VM	E
।	SYM	O