यूरोप	NNP	S
प्रस्थान	NN	I
करने	VM	I
से	PSP	I
पहले	NST	I
कुछ	QF	I
समय	NN	I
के	PSP	I
लिए	PSP	I
उन्हें	PRP	I
वापस	JJ	I
जबलपुर	NNP	I
जेल	NN	I
भेज	VM	I
दिया	VAUX	I
गया	VAUX	I
था	VAUX	E
,	SYM	O
जहां	PRP	S
उनके	PRP	I
भैया	NN	I
भी	RP	I
थे	VM	E
।	SYM	O