कभी-कभी	PRP	S
रकत	NN	I
का	PSP	I
थक़्का	NN	I
,	SYM	I
रक़्त	NNP	I
के	PSP	I
बहाव	NN	I
को	PSP	I
पूरी	JJ	I
तरह	NN	I
रोक	VM	I
देता	VAUX	I
है	VAUX	E
,	SYM	O
जिसका	PRP	S
भंयकर	JJ	I
परिणाम	NN	I
होता	VM	I
है-हृदय	VAUX	E
आघात	NN	I
अर्थात	CC	I
हार्ट	NNPC	I
अटैक	NNP	E
।	SYM	O