औद्योगीकरण	NN	S
के	PSP	I
अभाव	NN	I
के	PSP	I
कारण	PSP	I
परेशानी	NN	I
ज्होल	JJ	I
रहे	VAUX	I
ओडीसा	NNP	I
में	PSP	I
अतीत	NN	I
में	PSP	I
इस	DEM	I
तरह	NN	I
की	PSP	I
रणनीति	NN	I
कारगर	JJ	I
रही	VM	I
है	VAUX	E
।	SYM	O