हिजबुल्लाह	NNP	S
से	PSP	I
अरबों	NN	I
का	PSP	I
पल्ला	NN	I
झाडना	VM	I
ऐसा	DEM	I
आधार	NN	I
नहीं	NEG	I
है	VM	I
जिसपर	PRP	I
आगे	NST	I
बढा	VM	I
जाए	VAUX	I
यह	PRP	I
केवल	RP	I
छोटी	JJ	I
सी	RP	I
वास्तविकता	NN	I
है	VM	E
जिसका	PRP	S
इस	DEM	I
अतार्किक	JJ	I
युग	NN	I
में	PSP	I
स्वागत	NN	I
होना	VM	I
चाहिए	VAUX	E
।	SYM	O