इसके	PRP	S
बाद	NST	I
नरेंद्र	NNP	I
ने	PSP	I
उनके	PRP	I
ठहरने	VM	I
के	PSP	I
लिए	PSP	I
एक	QC	I
सुरक्षित	JJ	I
स्थान	NN	I
का	PSP	I
प्रबंध	NN	I
मौंहदिया	NNP	I
गांव	NN	I
में	PSP	I
किया	VM	E
जो	PRP	S
बलसोर	NNP	I
से	PSP	I
विशेष	JJ	I
दूर	NST	I
नहीं	NEG	I
है	VM	E
और	CC	O
यूनीवर्सल	NNPC	S
एम्पोरियम	NNP	I
नामक	JJ	I
व्यापारिक	JJ	I
केंद्र	NNPC	I
संप्रेषण	NN	I
का	PSP	I
माघ्यम	NN	I
बनाने	VM	I
के	PSP	I
लिए	PSP	I
खोला	VM	I
गया	VAUX	E
।	SYM	O