उन्होंने	PRP	S
सरकार	NN	I
से	PSP	I
उनके	PRP	I
पक्ष	NN	I
में	PSP	I
बाजार	NN	I
में	PSP	I
हस्तक्षेप	NN	I
करने	VM	E
और	CC	O
उनसे	PRP	S
कुछ	QF	I
अनिवार्य	JJ	I
खरीद	NN	I
करने	VM	I
का	PSP	I
अनुरोध	NN	I
किया	VM	E
।	SYM	O