इस	DEM	S
सकारात्मक	JJ	I
अर्थबोध	NN	I
में	PSP	I
स्वतंत्रता	NN	I
का	PSP	I
अर्थ	NN	I
होगा	VM	I
किसी	PRP	I
व्यक्ति	NN	I
की	PSP	I
अपनी	PRP	I
इच्छा	NN	I
के	PSP	I
अनुसार	PSP	I
कार्य	NN	I
करने	VM	I
की	PSP	I
स्वतंत्रता	NN	E
।	SYM	O