अन्य	JJ	S
कवियों	NN	I
में	PSP	I
भारतेन्दु	NNPC	I
हरिश्चन्द्र	NNPC	I
सुमित्रानन्दन	NNPC	I
पन्त	NNP	I
और	CC	I
श्रीधर	NNPC	I
पाठक	NNP	I
आदि	RP	I
ने	PSP	I
भी	RP	I
यत्र-तत्र	VM	I
गंगा	NNP	I
का	PSP	I
वर्णन	NN	I
किया	VM	I
है	VAUX	E
।	SYM	O