बहुत	INTF	S
सारे	QF	I
छोटे	JJ	I
खानी	JJ	I
समझौतों	NN	I
में	PSP	I
मकान	NNC	I
मालिक	NN	I
मरम्मत	NN	I
के	PSP	I
काम	NN	I
को	PSP	I
Landlord	SYM	I
and	SYM	I
Tenant	SYM	I
Act1985	SYM	I
\	SYM	I
अंतर्गत	NST	I
जिम्मेदार	JJ	I
होता	VM	I
है	VAUX	E
।	SYM	O