उनकी	PRP	S
जिम्मेदारियों	NN	I
में	PSP	I
शामिल	JJ	I
थे	VM	I
स्पेसहैब	NN	I
/	SYM	I
बल्ले-बल्ले	NN	I
/	SYM	I
फ़्रीस्टार	NN	I
लघुगुरुत्व	NNP	I
प्रयोग	NN	I
जिसके	PRP	S
लिए	PSP	I
कर्मचारी	NNC	I
दल	NN	I
ने	PSP	I
80	QC	I
प्रयोग	NN	I
किए	VM	E
जिनके	PRP	S
जरिए	PSP	I
पृथ्वी	NNP	I
व	CC	I
अंतरिक्ष	NNC	I
विज्ञान	NNPC	I
उन्नत	NNPC	I
तकनीक	NNC	I
विकास	NN	I
व	CC	I
अंतरिक्ष	NNC	I
यात्री	NNC	I
स्वास्थ्य	NN	I
व	CC	I
सुरक्षा	NN	I
का	PSP	I
अध्ययन	NN	I
हुआ	VM	E
।	SYM	O