मंत्रियों	NN	S
में	PSP	I
प्रचार	NN	I
पाने	VM	I
की	PSP	I
खातिर	PSP	I
अपने	PRP	I
विचार	NN	I
सार्वजनिक	JJ	I
करने	VM	I
का	PSP	I
उत्साह	NN	I
अगर	CC	I
समज्ह	NN	I
आता	VM	I
है	VAUX	E
तो	CC	S
इस	DEM	I
मामले	NN	I
में	PSP	I
जेटली	NNP	I
की	PSP	I
भावनात्मक	JJ	I
दखलंदाजी	NN	I
रहस्यमय	JJ	I
ही	RP	I
नजर	NN	I
आती	VM	I
है	VAUX	E
।	SYM	O