धार्मिक	JJ	S
नेता	NN	I
इसके	PRP	I
प्रति	PSP	I
पूरी	JJ	I
तरह	NN	I
से	PSP	I
सजग	JJ	I
थे	VM	E
तथा	CC	O
सभी	QF	S
तरह	NN	I
के	PSP	I
भेद	NNC	I
भाव	NN	I
को	PSP	I
समूल	JJ	I
उखाडने	VM	I
में	PSP	I
सक्रिय	JJ	I
थे	VM	E
।	SYM	O