उनका	PRP	S
विरोध	NN	I
करने	VM	I
वालों	PSP	I
में	PSP	I
उस	DEM	I
समय	NN	I
सबसे	INTF	I
मुख्य	JJ	I
दल	NN	I
भारतीय	NNPC	I
कम्यूनिस्ट	NNPC	I
पार्टी	NNP	I
और	CC	I
अन्य	JJ	I
वामपंथी	JJ	I
सहयोगी	JJ	I
दल	NN	I
थे	VM	E
।	SYM	O