उनकी	PRP	S
मांग	NN	I
है-जहां	NN	I
बाबरी	NNPC	I
मस्जिद	NN	I
थी	VM	I
वहां	PRP	I
परौ	NNPC	I
राम	NNPC	I
मंदिर	NNP	I
निर्माण	NN	I
की	PSP	I
सभी	QF	I
बाधाएं	NN	I
सरकार	NN	I
12	NNPC	I
मार्च	NNP	I
तक	PSP	I
दूर	NST	I
करे	VM	E
।	SYM	O