आपकी	PRP	S
सहायता	NN	I
से	PSP	I
,	SYM	I
आपसे	PRP	I
जुडे	VM	I
बच्चों	NN	I
में	PSP	I
सामाजिक	JJ	I
और	CC	I
सीखने	VM	I
से	PSP	I
सम्बंधित	JJ	I
कौशल	NN	I
विकसित	JJ	I
होंगे	VM	E
जिनसे	PRP	S
उन्हें	PRP	I
आजीवन	JJ	I
मदद	NN	I
मिलती	VM	I
रहेगी	VAUX	E
।	SYM	O