इसी	DEM	S
बहाने	NN	I
अंग्रेज	JJ	I
सरकार	NN	I
ने	PSP	I
सुभाषबाबू	NNP	I
को	PSP	I
गिरफतार	JJ	I
किया	VM	E
और	CC	O
बिना	RP	S
कोई	PRP	I
मुकदमा	NN	I
चलाए	VM	I
उन्हें	PRP	I
अनिश्चित	JJ	I
कालखंड	NN	I
के	PSP	I
लिए	PSP	I
म्यानमार	NNP	I
के	PSP	I
मंडाले	NNC	I
कारागृह	NN	I
में	PSP	I
बंदी	NN	I
बनाया	VM	E
।	SYM	O