उस	DEM	S
समय	NN	I
राजसभा	NN	I
में	PSP	I
भगवान्	NNC	I
श्रीकृष्ण	NNP	I
ने	PSP	I
माया	NNP	I
से	PSP	I
अपने	PRP	I
परम	NNC	I
दुर्धर्ष	JJ	I
विश्वरूप	NNP	I
का	PSP	I
दर्शन	NN	I
कराकर	VM	I
सबको	PRP	I
भयभीत	JJ	I
कर	VM	I
दिया	VAUX	E
।	SYM	O