पादचारियों	NN	S
,	SYM	I
साइकिल	NN	I
एवं	CC	I
मोटर	NNC	I
साइकिल	NNC	I
सवारों	NN	I
को	PSP	I
दिन	NN	I
में	PSP	I
चमकीले	JJ	I
एवं	CC	I
रात	NN	I
में	PSP	I
दिखने	VM	I
वाले	PSP	I
कपडे	NN	I
पहनने	VM	I
चाहिये	VAUX	E
।	SYM	O