1997	NNP	S
में	PSP	I
एबीसीएल	NNP	I
द्वारा	PSP	I
निर्मित	JJ	I
मृत्युदाता	NNP	I
(	SYM	I
Mrityudaata	SYM	I
)	SYM	I
फिल्म	NN	I
से	PSP	I
बच्चन	NNP	I
ने	PSP	I
अपने	PRP	I
अभिनय	NN	I
में	PSP	I
वापसी	NN	I
का	PSP	I
प्रयास	NN	I
किया	VM	E
।	SYM	O