इस	DEM	O
प्रकार	NN	O
के	PSP	S
अधिकांश	JJ	I
कार्यकलाप	NN	I
बम्बइ-	NNPC	I
प्रेसिडेंसी	NNPC	I
एसोसिएशन	NNP	I
और	CC	I
अंजुमन	NNPC	I
ऋए-	NNPC	I
इसऋद्दलाम	NNP	I
जैसी	PSP	I
विभिनऋद्दन	NNPC	I
संसऋद्दथाओं	NN	I
के	PSP	I
जरिये	PSP	I
संपनऋद्दन	NN	I
होते	VM	I
थे	VAUX	E
।	SYM	O