साल	NN	S
के	PSP	I
आखिर	NN	I
में	PSP	I
उन्हें	PRP	I
कलकत्ता	NNP	I
लाकर	VM	I
पहरेबंद	NNP	I
कैदी	NN	I
के	PSP	I
रूप	PSP	I
में	PSP	I
मेडिकल	NNC	I
कालेज	NN	I
में	PSP	I
भर्ती	NN	I
करा	VM	I
दिया	VAUX	I
गया	VAUX	E
।	SYM	O