संकलनकर्ताओं	NN	S
में	PSP	I
सबसे	INTF	I
अधिक	QF	I
विख़्यात	JJ	I
थे	VAUX	I
गुलाम	NNPC	I
अली	NNPC	I
आजाद	NNP	I
और	CC	I
लक्ष्मीनारायण	NNPC	I
शफीक	NNP	I
तथा	CC	I
कोषकारों	NN	I
में	PSP	I
टेकचंद	NNP	I
,	SYM	I
बहारे	NNP	I
आजम	NNP	I
के	PSP	I
संकलकर्ता	NN	I
,	SYM	I
मिरातुल	SYM	I
इश्तिला	NNP	I
के	PSP	I
आनंद	NNPC	I
राम	NNPC	I
मुशलिस	NNP	I
और	CC	I
सिराज-उल-	JJ	I
लुघात	NNP	I
के	PSP	I
सिराजुद्दीन	NNPC	I
खान	NNPC	I
आरजु	NNP	E
।	SYM	O