आपके	PRP	S
स्वास्थ्य	NN	I
को	PSP	I
हानि	NN	I
पहुँचाने	VM	I
की	PSP	I
संभावना	NN	I
रखने	VM	I
वाले	PSP	I
तत्वों	NN	I
पर	PSP	I
रोक	NN	I
लगाना	VM	E
या	CC	O
उनके	PRP	S
सम्पर्क	NN	I
में	PSP	I
आने	VM	E
पर	CC	O
पर्याप्त	JJ	S
नियंत्रण	NN	I
रखना	VM	E
।	SYM	O