भारतीय	JJ	S
वास्तुकला	NN	I
में	PSP	I
पश्चिमी	JJ	I
प्रभाव	NN	I
से	PSP	I
स्थान	NN	I
का	PSP	I
सदुपयोंग	NN	I
आया	VM	I
,	SYM	I
विशेषकर	CC	I
सीधी	JJ	I
रेखाओं	NN	I
के	PSP	I
प्रयोग	NN	I
तथा	CC	I
आधुनिक	NNPC	I
स्वास्थ्य	NNPC	I
विभाग	NNP	I
को	PSP	I
ध्यान	NN	I
में	PSP	I
रखने	VM	I
के	PSP	I
कारण	PSP	E
।	SYM	O