अनेकों	QF	S
फॉण्ट	NNC	I
परिवर्तक	NNC	I
-	SYM	I
वैज्ञानिक	JJ	I
एवं	CC	I
तकनीकी	JJ	I
हिन्दी	NNC	I
समूह	NN	I
के	PSP	I
फाइल	NNC	I
सेक्शन	NN	I
में	PSP	I
जावास्क्रिप्ट	NN	I
पर	PSP	I
आधारित	JJ	I
बीस	QC	I
से	PSP	I
अधिक	QF	I
फॉण्ट	NNC	I
परिवर्तक	NN	I
उपलब्ध	JJ	I
हैं	VM	E
।	SYM	O