ऊष्ण-कटिबंधीय	NNP	S
क्षेत्र	NN	I
में	PSP	I
दीमक	NNC	I
भूमि	NN	I
के	PSP	I
स्वरूप	NN	I
और	CC	I
दृढता	NN	I
को	PSP	I
उसी	DEM	I
प्रकार	NN	I
बनाए	VM	I
रखने	VAUX	I
में	PSP	I
सहायता	NN	I
करती	VM	I
है	VAUX	I
,	SYM	I
जैसे	CCC	I
कि	CC	I
ब्रिटेन	NNP	I
में	PSP	I
केंचुआ	JJ	I
करता	VM	I
है	VAUX	E
।	SYM	O