दिल्ली	NNP	S
के	PSP	I
सुल्तानों	NNP	I
और	CC	I
मुगल	NNPC	I
बादशाहों	NNP	I
ने	PSP	I
इसके	PRP	I
साथ	NST	I
छेडखानी	NN	I
करना	VM	I
लाभप्रद	JJ	I
और	CC	I
व्यावहारिक	JJ	I
नहीं	NEG	I
समझा	VM	E
और	CC	O
उन्हें	PRP	S
पहले	NST	I
की	PSP	I
तरह	PSP	I
अपना	PRP	I
काम	NN	I
करने	VM	I
दिया	VAUX	E
।	SYM	O