बहुत	INTF	S
सी	RP	I
स्थानीय	JJ	I
सत्ताएं	NN	I
और	CC	I
हाउजिंग	NNC	I
असोसिएशनज	NNPC	I
आश्रय	NNPC	I
आवास	NN	I
प्रदान	NN	I
करती	VM	I
है	VAUX	E
जो	PRP	S
रहने	VM	I
के	PSP	I
लिये	PSP	I
आत्मनिर्भर	JJ	I
आवास	NN	I
में	PSP	I
रहने	VM	I
का	PSP	I
मौका	NN	I
प्रदान	NN	I
करती	VM	I
हैं	VAUX	E
जहां	PRP	S
सहायता	NN	I
करने	VM	I
के	PSP	I
लिये	PSP	I
वार्डन	NN	I
हमेशा	RB	I
होता	VM	I
है	VAUX	E
।	SYM	O