सन्	NNPC	S
1934	NNP	I
के	PSP	I
बाद	NST	I
स्थितियों	NN	I
में	PSP	I
सुधार	NN	I
आया	VM	I
,	SYM	I
लेकिन	CC	I
तकनीकी	JJ	I
परिवर्तनों	NN	I
की	PSP	I
समता	NN	I
कायम	JJ	I
रखने	VM	I
के	PSP	I
लिए	PSP	I
टैरिफ	NNC	I
बोर्ड	NN	I
को	PSP	I
संयंत्र	NN	I
में	PSP	I
मूलभूत	JJ	I
परिवर्तन	NN	I
की	PSP	I
आवश्यकता	NN	I
महसूस	JJ	I
हुई	VM	E
।	SYM	O