कुछ	QF	S
अरसे	NN	I
से	PSP	I
अनेक	QF	I
इस्लमी	JJ	I
गुट	NN	I
ब्रिटेन	NNP	I
को	PSP	I
कश्मीर	NNP	I
के	PSP	I
तथाकथित	JJ	I
जेहाद	NN	I
की	PSP	I
खातिर	PSP	I
पैसा	NN	I
जमा	JJ	I
करने	VM	I
और	CC	I
आतंकवादियों	NN	I
को	PSP	I
प्रशिक्षण	NN	I
देने	VM	I
के	PSP	I
लिए	PSP	I
इस्तेमाल	NN	I
करते	VM	I
आ	VAUX	I
रहे	VAUX	I
हैं-बिल्कुल	VAUX	I
उसी	DEM	I
तरह	NN	I
जैसे	CC	I
1980	NNP	I
वाले	PSP	I
दशक	NN	I
में	PSP	I
जगजीत	NNPC	I
सिंह	NNPC	I
चौहान	NNP	I
खालिस्तानी	NNPC	I
आंदोलन	NN	I
के	PSP	I
लिए	PSP	I
समर्थन	NN	I
जुटाया	VM	I
करता	VAUX	I
था	VAUX	E
।	SYM	O