आप	PRP	S
मरम्मत	NN	I
के	PSP	I
कुछ	QF	I
बहुत	INTF	I
जरुरी	JJ	I
काम	NN	I
शीघ्र	RB	I
करवा	VM	I
सकते	VAUX	I
हैं	VAUX	E
और	CC	O
इन	PRP	S
पर	PSP	I
आपको	PRP	I
कुछ	QF	I
ख़र्च	NN	I
नहीं	NEG	I
करना	VM	I
होगा	VAUX	E
।	SYM	O