वाहन	NN	S
चलाने	VM	I
के	PSP	I
पहले	NST	I
अथवा	CC	I
खतरनाक	JJ	I
मशीन	NN	I
पर	PSP	I
काम	NN	I
करने	VM	I
के	PSP	I
पहले	NST	I
अथवा	CC	I
दवा	NN	I
लेने	VM	I
के	PSP	I
पश्चात	NST	I
मद्यपान	NN	I
नहीं	NEG	I
करना	VM	I
चाहिये	VAUX	E
।	SYM	O