शोZषित	NNPC	S
परिश्रमी	JJ	I
श्रमिक	NN	I
सारे	QF	I
समुदाय	NN	I
की	PSP	I
सामूहिक	JJ	I
भलाई	NN	I
के	PSP	I
लिए	PSP	I
योगदान	NN	I
देZते	VM	I
हैं	VM	I
क़्योंकि	RB	I
परिश्रम	NN	I
का	PSP	I
फल	NN	I
परिश्रम	NN	I
करने	VM	I
वाले	PSP	I
को	PSP	I
नहीं	NEG	I
बल्कि	CC	I
समुदाय	NN	I
को	PSP	I
मिलता	VM	I
है	VAUX	E
।	SYM	O