XDMCP	SYM	S
से	PSP	I
होकर	VM	I
दूरस्थ	JJ	I
कनेक्शन	NN	I
को	PSP	I
“TimedLogin”	NN	I
में	PSP	I
लॉगिन	NN	I
होने	VM	I
देने	VAUX	I
के	PSP	I
लिए	PSP	I
स्वीकृत	JJ	I
किया	VM	I
जायेगा	VAUX	I
,	SYM	I
पहले	NST	I
कंसोल	NN	I
पर	PSP	I
स्थानीय	JJ	I
उपयोक्ता	NN	I
की	PSP	I
तरह	PSP	E
।	SYM	O