प्रदेश	NN	S
के	PSP	I
अन्य	JJ	I
महत्त्वपूर्ण	JJ	I
शहर	NN	I
हैं	VM	I
आगरा	NNPC	I
अलीगढ	NNP	I
अयोध्या	NNP	I
बरेली	NNP	I
मेरठ	NNPC	I
वाराणसी	NNP	I
(	SYM	I
बनारस	NNP	I
)	SYM	I
गोरखपुर	NNPC	I
गाजियाबाद	NNP	I
मुरादाबाद	NNP	I
सहारनपुर	NNPC	I
फ़ैजाबाद	NNP	I
कानपुर	NNP	E
।	SYM	O