परंतु	CC	O
यदि	CC	S
कोई	PRP	I
दोष	NN	I
जन्म	NN	I
के	PSP	I
तुरंत	RP	I
बाद	NST	I
दिखाई	VM	I
देने	VAUX	I
लगता	VAUX	I
है	VAUX	E
तथा	CC	O
इतना	QF	S
गंभीर	JJ	I
होता	VM	I
है	VAUX	E
कि	CC	O
रोग	NN	S
पीडित	JJ	I
व्यक्ति	NN	I
प्रजनन	NN	I
के	PSP	I
योग़्य	NN	I
नहीं	NEG	I
रहते	VM	E
तो	RP	S
उन	DEM	I
व्यक्तियों	NN	I
का	PSP	I
बंध्याकरण	NN	I
उचित	JJ	I
नहीं	NEG	I
लगता	VM	I
हंसिया	NNP	I
रोग	NN	I
इसी	DEM	I
तरह	NN	I
की	PSP	I
एक	QC	I
रोग	NN	I
है	VM	E
।	SYM	O