सात	QC	S
वर्ष	NN	I
की	PSP	I
अवस्था	NN	I
में	PSP	I
उनकी	PRP	I
माता	NN	I
तथा	CC	I
चौदह	QC	I
वर्ष	NN	I
की	PSP	I
अवस्था	NN	I
में	PSP	I
पिता	NN	I
का	PSP	I
देहान्त	NN	I
हो	VM	I
जाने	VAUX	I
के	PSP	I
कारण	PSP	I
उनका	PRP	I
प्रारंभिक	JJ	I
जीवन	NN	I
संघर्षमय	JJ	I
रहा	VM	E
।	SYM	O