यहीं	PRP	S
भारत	NNP	I
के	PSP	I
अधिकांश	QF	I
विशिष्ट	JJ	I
तकनीकी	JJ	I
उद्योग	NN	I
स्थित	JJ	I
हैं	VM	E
जिनके	PRP	S
पास	NST	I
आधुनिक	JJ	I
औद्योगिक	JJ	I
आधार	NNC	I
संरचना	NN	I
के	PSP	I
साथ	NST	I
ही	RP	I
अपार	JJ	I
मात्रा	NN	I
में	PSP	I
कुशल	JJ	I
मानव	NNPC	I
संसाधन	NN	I
भी	RP	I
हैं	VM	E
।	SYM	O