संगठन	NN	S
कर्ताओं	NN	I
की	PSP	I
योजना	NN	I
यह	PRP	I
थी	VM	E
कि	CC	O
वैध	JJ	S
साम्यवादी	JJ	I
पार्टी	NN	I
बनाई	VM	I
जाए	VAUX	E
पर	PSP	S
संगठनकर्ता	NN	I
निकाल	VM	I
बाहर	NST	I
किए	VM	I
गए	VAUX	E
और	CC	O
साम्यवादी	JJ	S
असली	JJ	I
साम्यवादी	JJ	I
पार्टी	NN	I
बनाने	VM	I
में	PSP	I
सफल	JJ	I
हुए	VM	E
।	SYM	O