इसी	DEM	S
बीच	NST	I
गेंदबाज	NN	I
की	PSP	I
टीम	NN	I
के	PSP	I
अन्य	JJ	I
सदस्य	NN	I
मैदान	NN	I
में	PSP	I
क्षेत्ररक्षक	NN	I
के	PSP	I
रूप	PSP	I
में	PSP	I
अलग	JJ	I
अलग	JJ	I
स्थितियों	NN	I
में	PSP	I
खडे	JJ	I
रहते	VM	I
हैं	VAUX	I
ये	DEM	I
खिलाडी	NN	I
बल्लेबाज	NN	I
को	PSP	I
दौड	NN	I
बनाने	VM	I
से	PSP	I
रोकने	VM	I
के	PSP	I
लिए	PSP	I
गेंद	NN	I
को	PSP	I
पकडने	VM	I
का	PSP	I
प्रयास	NN	I
करते	VM	I
हैं	VAUX	I
और	CC	I
यदि	CC	I
सम्भव	JJ	I
हो	VM	E
तो	CC	S
उसे	PRP	I
आउट	UNK	I
करने	VM	I
की	PSP	I
कोशिश	NN	I
करते	VM	I
हैं	VAUX	E
।	SYM	O