ड्रग्स	NN	S
का	PSP	I
नियमित	JJ	I
रूप	NN	I
से	PSP	I
इस्तमाल	NN	I
करने	VM	I
वाले	PSP	I
अधिकतर	JJ	I
युवा	JJ	I
बीस	QC	I
साल	NN	I
की	PSP	I
आयु	NN	I
के	PSP	I
आस-पास	NST	I
के	PSP	I
होते	VM	I
हैं	VAUX	E
।	SYM	O