कोपेन	NNP	S
ने	PSP	I
अपने	PRP	I
वर्गीकरण	NN	I
में	PSP	I
संसार	NN	I
को	PSP	I
पाँच	QC	I
वृहद	JJ	I
जलवायु	NNC	I
वर्गों	NN	I
और	CC	I
उनको	PRP	I
भी	RP	I
तेरह	QC	I
उपवर्गों	NN	I
में	PSP	I
विभाजित	JJ	I
किया	VM	I
है	VAUX	E
।	SYM	O