तापमान	NN	S
और	CC	I
वर्षा	NN	I
के	PSP	I
संयुक्त	JJ	I
प्रभाव	NN	I
और	CC	I
इनके	PRP	I
वितरण	NN	I
को	PSP	I
प्रभावित	JJ	I
करने	VM	I
वाले	PSP	I
अन्य	JJ	I
कारकों	NN	I
को	PSP	I
ध्यान	NN	I
में	PSP	I
रखते	VM	I
हुये	VAUX	I
आधुनिक	JJ	I
वैज्ञानिकों	NN	I
ने	PSP	I
जलवायु	NNC	I
प्रकारों	NN	I
के	PSP	I
कई	QF	I
वर्गीकरण	NN	I
किये	VM	I
हैं	VAUX	E
।	SYM	O