यद्यपि	CC	O
वैज्ञानिकों	NN	S
द्वारा	PSP	I
संसार	NN	I
के	PSP	I
प्रमुख	JJ	I
जलवायु	NNC	I
प्रकारों	NN	I
के	PSP	I
उचित	JJ	I
अध्ययन	NN	I
के	PSP	I
लिये	PSP	I
उनके	PRP	I
वर्गीकरण	NN	I
के	PSP	I
कई	QF	I
प्रयास	NN	I
किये	VM	I
गये	VAUX	I
हैं	VAUX	E
।	SYM	O