इसी	DEM	O
प्रकार	NN	O
ठण्डी	JJ	S
धाराओं	NN	I
के	PSP	I
ऊपर	NST	I
से	PSP	I
गुजरने	VM	I
वाली	PSP	I
पवनें	NN	I
ठण्डी	JJ	I
होकर	VM	I
आन्तरिक	JJ	I
भागो	NN	I
में	PSP	I
तापमान	NN	I
को	PSP	I
कम	QF	I
करके	VM	I
,	SYM	I
कोहरा	NN	I
और	CC	I
धुंध	NN	I
उत्पन्न	JJ	I
करती	VM	I
हैं	VAUX	E
।	SYM	O