मौसम	NNC	S
कार्यालय	NN	I
सारे	QF	I
देश	NN	I
में	PSP	I
फैली	VM	I
अपनी	PRP	I
अनेक	QF	I
बेधशालाओं	NN	I
द्वारा	PSP	I
तापमान	NN	I
,	SYM	I
पवन	NNP	I
,	SYM	I
मेघाच्छादन	NNP	I
,	SYM	I
वर्षा	NN	I
और	CC	I
अन्य	JJ	I
वायुमंडलीय	JJ	I
घटनाओं	NN	I
के	PSP	I
बारे	PSP	I
में	PSP	I
आंकडे	NN	I
एकत्र	JJ	I
करता	VM	I
है	VAUX	E
।	SYM	O