उदाहरणार्थ	RB	O
मुम्बई	NNP	S
और	CC	I
नागपुर	NNP	I
दोनों	QC	I
नगर	NN	I
लगभग	RP	I
एक	QC	I
ही	RP	I
अक्षांश	NN	I
पर	PSP	I
स्थित	JJ	I
हैं	VM	E
परन्तु	CC	O
समुद्र	NN	S
के	PSP	I
प्रभाव	NN	I
के	PSP	I
कारण	PSP	I
मुम्बई	NNP	I
में	PSP	I
नागपुर	NNP	I
की	PSP	I
अपेक्षा	PSP	I
नीचे	NST	I
तापमान	NN	I
रहते	VM	I
हैं	VAUX	E
और	CC	O
अधिक	QF	S
वर्षा	NN	I
होती	VM	I
हैं	VAUX	E
।	SYM	O