किस	WQ	S
विस्तृत	JJ	I
क्षेत्र	NN	I
में	PSP	I
वर्ष	NN	I
की	PSP	I
विभिन्न	JJ	I
ऋतुओं	NN	I
की	PSP	I
औसत	NN	I
मौसमी	JJ	I
दशाओं	NN	I
को	PSP	I
उस	DEM	I
क्षेत्र	NN	I
की	PSP	I
जलवायु	NN	I
कहते	VM	I
हैं	VAUX	E
।	SYM	O