इसके	PRP	O
विपरीत	PSP	O
बादलों	NN	S
से	PSP	I
घिरे	VM	I
आकाश	NN	I
और	CC	I
भारी	JJ	I
वर्षा	NN	I
के	PSP	I
कारण	PSP	I
तिरुवनन्तपुरम	NNP	I
में	PSP	I
ताप	NN	I
परिसर	NN	I
बहुत	INTF	I
कम	QF	I
होता	VM	I
है	VAUX	E
।	SYM	O