उत्तरी	JJ	S
अटलांटिक	NNPC	I
महासागर	NNP	I
में	PSP	I
बर्जन	NNP	I
नामक	JJ	I
बन्दरगाह	NN	I
(	SYM	I
नार्वे	NNP	I
)	SYM	I
गर्म	JJ	I
उत्तरी	NNPC	I
अंध	JJ	I
महासागरीय	JJ	I
प्रवाह	NN	I
के	PSP	I
कारण	PSP	I
जाडे	NN	I
में	PSP	I
बर्फ	NN	I
के	PSP	I
जमने	VM	I
से	PSP	I
बचा	VM	I
रहता	VAUX	I
है	VAUX	E
जबकि	CC	O
कनाडा	NNP	S
का	PSP	I
क्यूबैक	NNPC	I
बन्दरगाह	NNPC	I
जाडे	NNP	I
के	PSP	I
महीनों	NN	I
में	PSP	I
ठण्डी	JJ	I
लैब्राडोर	NNP	I
धारा	NN	I
के	PSP	I
प्रभाव	NN	I
में	PSP	I
आकर	VM	I
बर्फ	NN	I
से	PSP	I
जम	VM	I
जाता	VAUX	I
है	VAUX	E
।	SYM	O