ये	DEM	S
तमाम	QF	I
विशेषताएं	NN	I
जहां	PRP	S
हारमनी-संगीत	NN	I
के	PSP	I
लिए	PSP	I
अत्यंत	INTF	I
महत्वपूर्ण	JJ	I
और	CC	I
सौंदर्यवर्द्धक	NN	I
हैं	VM	I
,	SYM	I
वहां	PRP	I
भारतीय	NNPC	I
संगीत	NNC	I
प्रतिभा	NN	I
के	PSP	I
लिए	PSP	I
बिल्कुल	RB	I
परायी	VM	I
हैं	VM	E
।	SYM	O