कनास	NNP	S
में	PSP	I
वाश्वर्न	NNPC	I
विश्वविद्यालय	NN	I
में	PSP	I
कानून	NN	I
की	PSP	I
शिक्षा	NN	I
ग्रहण	NN	I
करते	VM	I
हुये	VAUX	I
मेफील्ड	NNP	I
ने	PSP	I
मुस्लिम	NNPC	I
स्टूडेन्ट	NNPC	I
एसोसिएशन	NNP	I
की	PSP	I
शाखा	NN	I
को	PSP	I
संगठित	JJ	I
करने	VM	I
में	PSP	I
सहायता	NN	I
की	VM	E
जो	PRP	S
जोनाथन	NNPC	I
डाउड	NNPC	I
गेली	NNP	I
के	PSP	I
अनुसार	PSP	I
प्रत्यक्ष	JJ	I
राजनीतिक	JJ	I
संगठन	NN	I
है	VM	E
जो	PRP	S
कट्टरपंथी	JJ	I
इस्लामी	JJ	I
विचारधारा	NN	I
के	PSP	I
साथ	NST	I
एकता	NN	I
प्रदर्शित	JJ	I
करते	VM	I
हुये	VAUX	E
कुछ	QF	I
अवसरों	NN	I
पर	PSP	I
हिंसात्मक	JJ	I
गतिविधियों	NN	I
के	PSP	I
साथ	NST	I
वहावीबाद	NNP	I
,	SYM	I
अमेरिका	NNP	I
विरोध	NN	I
और	CC	I
सेमेटिक	JJ	I
विरोध	NN	I
को	PSP	I
प्रोत्साहित	JJ	I
करता	VM	I
है	VAUX	E
।	SYM	O