जिला	NNC	S
मजिस्ट्रेट	NN	I
,	SYM	I
जो	PRP	S
राज्य	NNC	I
सरकार	NN	I
के	PSP	I
नियंत्रण	NN	I
में	PSP	I
होते	VM	I
हैं	VAUX	E
,	SYM	I
समय	NN	I
समय	NN	I
पर	PSP	I
उन	DEM	I
स्थानीय	JJ	I
सीमाओं	NN	I
को	PSP	I
परिनिश्चित	JJ	I
करते	VM	I
हैं	VAUX	E
जिनके	PRP	S
भीतर	NST	I
कार्यपालक	NNC	I
मजिस्ट्रेट	NN	I
अपनी	PRP	I
शक्तियों	NN	I
का	PSP	I
प्रयोग	NN	I
कर	VM	I
सकते	VAUX	E
हैं	VAUX	E
।	SYM	O