ये	PRP	S
ऐसे	DEM	I
न्यायिक	JJ	I
उपकरण	NN	I
है	VM	E
जिनका	PRP	S
लक्ष्य	NN	I
जनहित	NN	I
प्राप्त	JJ	I
करना	VM	I
है	VAUX	E
इनका	PRP	I
ल्क्ष्य	NN	I
तीव्र	JJ	I
तथा	CC	I
सस्ता	JJ	I
न्याय	NN	I
एक	QC	I
आम	JJ	I
आदमी	NN	I
को	PSP	I
दिलवाना	VM	E
तथा	CC	O
कार्यपालिका	NNPC	S
विधायिका	NN	I
को	PSP	I
उनके	PRP	I
संवैधानिक	JJ	I
कार्य	NN	I
करवाने	VM	I
हेतु	PSP	I
किया	VM	I
जाता	VAUX	I
है	VAUX	E
।	SYM	O