भारतीय	JJ	S
कार्बनिक	NNPC	I
रासायनिक	JJ	I
तत्व	NN	I
ने	PSP	I
,	SYM	I
जिसका	PRP	S
आधार	NN	I
संकुचित	JJ	I
था	VM	I
,	SYM	I
अपने	PRP	I
को	PSP	I
उत्तरप्रदेश	NNP	I
और	CC	I
बिहार	NNP	I
के	PSP	I
चीनी	JJ	I
उत्पादक	JJ	I
क्षेत्रों	NN	I
में	PSP	I
अल्कोहल	NN	I
की	PSP	I
उपलब्धि	NN	I
तक	PSP	I
सीमित	JJ	I
रखा	VM	I
जमशेदपुर	NNP	I
और	CC	I
बर्नपुर	NNP	I
में	PSP	I
कोक	NNC	I
चूल्हे	NN	I
जैसे	PSP	I
सहउत्पादों	NN	I
ने	PSP	I
अपने	PRP	I
लिए	PSP	I
सुदृढ	JJ	I
आधारशिला	NN	I
बनायी	VM	E
।	SYM	O