वह	PRP	S
महान	JJ	I
अभिनेत्री	NN	I
थी	VM	E
और	CC	O
जिस	DEM	S
समृद्ध	JJ	I
अभिनय	NN	I
के	PSP	I
आधार	NN	I
पर	PSP	I
उसने	PRP	I
पिछले	JJ	I
अनेक	QF	I
दशकों	NN	I
में	PSP	I
लाखों	QC	I
लोगों	NN	I
का	PSP	I
मनोरंजन	NN	I
किया	VM	I
गया	VAUX	E
,	SYM	I
उसे	PRP	I
बहुत	QF	I
याद	NN	I
किया	VM	I
जाएगा	VAUX	E
।	SYM	O